#####
#@  #
#.$ #
##$ #
 #. #
 ####
; Level One

##########
#  @#..$ #
# ###$   #
#     ####
#######
; Level Two

##############
# $ . $ . $ .###
#@# $ . $ .  $.#
################
; Level 3