#####
#@  #
#.$ #
##$ #
 #. #
 ####
; Level One

##########
#  @#..$ #
# ###$   #
#     ####
#######
; Level Two

##############
# $ . $ . $ .#
#@# $ . $ .  #
##############
; Level Three

############
#@.$       #
# ######## #
#          #
############
; Level Four

###########
#@ $.#.$ @#
###########
; El Chapo

############
#@   #     #
# ## # # #$#
# #  # # #.#
# # ## # ###
# #    # #.#
# ###### #$#
#          #
############
; Math class